"Novads","Statuss","DzNor","DzDekl","DzReg","NavSpeka","Kopa"
"DAUGAVPILS","LATVIJAS PILSONIS",24,71524,1,1372,72921
"DAUGAVPILS","LATVIJAS PAGAIDU AIZSARDZIBA",0,0,0,0,0
"DAUGAVPILS","LATVIJAS NEPILSONIS",6,13299,0,401,13706
"DAUGAVPILS","LATVIJAS BEGLIS",0,0,0,0,0
"DAUGAVPILS","LATVIJAS BEZVALSTNIEKS",0,5,0,0,5
"DAUGAVPILS","LATVIJAS ALTERNATIVAIS",0,0,0,0,0
"DAUGAVPILS","PAREJIE",5,6084,2,53,6144
"JELGAVA","LATVIJAS PILSONIS",14,50183,0,1154,51351
"JELGAVA","LATVIJAS PAGAIDU AIZSARDZIBA",0,0,0,0,0
"JELGAVA","LATVIJAS NEPILSONIS",6,7320,1,494,7821
"JELGAVA","LATVIJAS BEGLIS",0,2,0,0,2
"JELGAVA","LATVIJAS BEZVALSTNIEKS",0,2,0,1,3
"JELGAVA","LATVIJAS ALTERNATIVAIS",0,6,0,0,6
"JELGAVA","PAREJIE",2,1923,0,54,1979
"JEKABPILS","LATVIJAS PILSONIS",4,20100,157,618,20879
"JEKABPILS","LATVIJAS PAGAIDU AIZSARDZIBA",0,0,0,0,0
"JEKABPILS","LATVIJAS NEPILSONIS",3,2149,1,122,2275
"JEKABPILS","LATVIJAS BEGLIS",0,0,0,0,0
"JEKABPILS","LATVIJAS BEZVALSTNIEKS",0,2,0,0,2
"JEKABPILS","LATVIJAS ALTERNATIVAIS",0,0,0,0,0
"JEKABPILS","PAREJIE",0,430,1,13,444
"JURMALA","LATVIJAS PILSONIS",18,42623,1,920,43562
"JURMALA","LATVIJAS PAGAIDU AIZSARDZIBA",0,0,0,0,0
"JURMALA","LATVIJAS NEPILSONIS",1,7286,0,455,7742
"JURMALA","LATVIJAS BEGLIS",0,6,0,0,6
"JURMALA","LATVIJAS BEZVALSTNIEKS",0,5,0,0,5
"JURMALA","LATVIJAS ALTERNATIVAIS",0,5,0,0,5
"JURMALA","PAREJIE",7,5633,0,84,5724
"LIEPAJA","LATVIJAS PILSONIS",8,58097,12,1348,59465
"LIEPAJA","LATVIJAS PAGAIDU AIZSARDZIBA",0,0,0,0,0
"LIEPAJA","LATVIJAS NEPILSONIS",5,10658,1,740,11404
"LIEPAJA","LATVIJAS BEGLIS",0,1,0,0,1
"LIEPAJA","LATVIJAS BEZVALSTNIEKS",0,8,0,0,8
"LIEPAJA","LATVIJAS ALTERNATIVAIS",0,0,0,0,0
"LIEPAJA","PAREJIE",18,5648,3,57,5726
"REZEKNE","LATVIJAS PILSONIS",2,27813,0,522,28337
"REZEKNE","LATVIJAS PAGAIDU AIZSARDZIBA",0,0,0,0,0
"REZEKNE","LATVIJAS NEPILSONIS",0,1599,0,57,1656
"REZEKNE","LATVIJAS BEGLIS",0,0,0,0,0
"REZEKNE","LATVIJAS BEZVALSTNIEKS",0,0,0,0,0
"REZEKNE","LATVIJAS ALTERNATIVAIS",0,0,0,0,0
"REZEKNE","PAREJIE",2,675,0,35,712
"RIGA","LATVIJAS PILSONIS",167,517940,355,11398,529860
"RIGA","LATVIJAS PAGAIDU AIZSARDZIBA",0,0,0,0,0
"RIGA","LATVIJAS NEPILSONIS",26,113733,228,6576,120563
"RIGA","LATVIJAS BEGLIS",2,62,0,17,81
"RIGA","LATVIJAS BEZVALSTNIEKS",0,93,0,4,97
"RIGA","LATVIJAS ALTERNATIVAIS",0,90,0,30,120
"RIGA","PAREJIE",166,48543,15,1619,50343
"VALMIERA","LATVIJAS PILSONIS",0,23119,40,353,23512
"VALMIERA","LATVIJAS PAGAIDU AIZSARDZIBA",0,0,0,0,0
"VALMIERA","LATVIJAS NEPILSONIS",0,1127,3,43,1173
"VALMIERA","LATVIJAS BEGLIS",0,0,0,0,0
"VALMIERA","LATVIJAS BEZVALSTNIEKS",0,0,0,0,0
"VALMIERA","LATVIJAS ALTERNATIVAIS",0,0,0,0,0
"VALMIERA","PAREJIE",0,166,0,5,171
"VENTSPILS","LATVIJAS PILSONIS",3,29596,0,604,30203
"VENTSPILS","LATVIJAS PAGAIDU AIZSARDZIBA",0,0,0,0,0
"VENTSPILS","LATVIJAS NEPILSONIS",0,5668,0,259,5927
"VENTSPILS","LATVIJAS BEGLIS",0,2,0,0,2
"VENTSPILS","LATVIJAS BEZVALSTNIEKS",0,5,0,0,5
"VENTSPILS","LATVIJAS ALTERNATIVAIS",0,0,0,0,0
"VENTSPILS","PAREJIE",1,2385,0,39,2425
"AGLONAS NOVADS","LATVIJAS PILSONIS",1,3323,0,32,3356
"AGLONAS NOVADS","LATVIJAS PAGAIDU AIZSARDZIBA",0,0,0,0,0
"AGLONAS NOVADS","LATVIJAS NEPILSONIS",1,189,0,2,192
"AGLONAS NOVADS","LATVIJAS BEGLIS",0,0,0,0,0
"AGLONAS NOVADS","LATVIJAS BEZVALSTNIEKS",0,0,0,0,0
"AGLONAS NOVADS","LATVIJAS ALTERNATIVAIS",0,0,0,0,0
"AGLONAS NOVADS","PAREJIE",0,41,0,0,41
"AIZKRAUKLES NOVADS","LATVIJAS PILSONIS",0,7669,1,137,7807
"AIZKRAUKLES NOVADS","LATVIJAS PAGAIDU AIZSARDZIBA",0,0,0,0,0
"AIZKRAUKLES NOVADS","LATVIJAS NEPILSONIS",0,762,0,20,782
"AIZKRAUKLES NOVADS","LATVIJAS BEGLIS",0,0,0,0,0
"AIZKRAUKLES NOVADS","LATVIJAS BEZVALSTNIEKS",0,1,0,0,1
"AIZKRAUKLES NOVADS","LATVIJAS ALTERNATIVAIS",0,0,0,0,0
"AIZKRAUKLES NOVADS","PAREJIE",0,94,0,3,97
"AIZPUTES NOVADS","LATVIJAS PILSONIS",0,8590,1,85,8676
"AIZPUTES NOVADS","LATVIJAS PAGAIDU AIZSARDZIBA",0,0,0,0,0
"AIZPUTES NOVADS","LATVIJAS NEPILSONIS",0,211,0,6,217
"AIZPUTES NOVADS","LATVIJAS BEGLIS",0,0,0,0,0
"AIZPUTES NOVADS","LATVIJAS BEZVALSTNIEKS",0,0,0,0,0
"AIZPUTES NOVADS","LATVIJAS ALTERNATIVAIS",0,0,0,0,0
"AIZPUTES NOVADS","PAREJIE",0,32,0,4,36
"AKNISTES NOVADS","LATVIJAS PILSONIS",0,2501,1,11,2513
"AKNISTES NOVADS","LATVIJAS PAGAIDU AIZSARDZIBA",0,0,0,0,0
"AKNISTES NOVADS","LATVIJAS NEPILSONIS",0,194,0,1,195
"AKNISTES NOVADS","LATVIJAS BEGLIS",0,0,0,0,0
"AKNISTES NOVADS","LATVIJAS BEZVALSTNIEKS",0,0,0,0,0
"AKNISTES NOVADS","LATVIJAS ALTERNATIVAIS",0,0,0,0,0
"AKNISTES NOVADS","PAREJIE",0,17,0,0,17
"ALOJAS NOVADS","LATVIJAS PILSONIS",1,4850,0,14,4865
"ALOJAS NOVADS","LATVIJAS PAGAIDU AIZSARDZIBA",0,0,0,0,0
"ALOJAS NOVADS","LATVIJAS NEPILSONIS",0,172,0,1,173
"ALOJAS NOVADS","LATVIJAS BEGLIS",0,0,0,0,0
"ALOJAS NOVADS","LATVIJAS BEZVALSTNIEKS",0,0,0,0,0
"ALOJAS NOVADS","LATVIJAS ALTERNATIVAIS",0,0,0,0,0
"ALOJAS NOVADS","PAREJIE",0,10,0,0,10
"ALSUNGAS NOVADS","LATVIJAS PILSONIS",0,1400,4,6,1410
"ALSUNGAS NOVADS","LATVIJAS PAGAIDU AIZSARDZIBA",0,0,0,0,0
"ALSUNGAS NOVADS","LATVIJAS NEPILSONIS",0,16,1,0,17
"ALSUNGAS NOVADS","LATVIJAS BEGLIS",0,0,0,0,0
"ALSUNGAS NOVADS","LATVIJAS BEZVALSTNIEKS",0,0,0,0,0
"ALSUNGAS NOVADS","LATVIJAS ALTERNATIVAIS",0,0,0,0,0
"ALSUNGAS NOVADS","PAREJIE",0,3,0,0,3
"ALUKSNES NOVADS","LATVIJAS PILSONIS",1,15449,8,142,15600
"ALUKSNES NOVADS","LATVIJAS PAGAIDU AIZSARDZIBA",0,0,0,0,0
"ALUKSNES NOVADS","LATVIJAS NEPILSONIS",0,550,0,18,568
"ALUKSNES NOVADS","LATVIJAS BEGLIS",0,0,0,0,0
"ALUKSNES NOVADS","LATVIJAS BEZVALSTNIEKS",0,1,0,0,1
"ALUKSNES NOVADS","LATVIJAS ALTERNATIVAIS",0,0,0,0,0
"ALUKSNES NOVADS","PAREJIE",2,162,0,10,174
"AMATAS NOVADS","LATVIJAS PILSONIS",0,5221,0,24,5245
"AMATAS NOVADS","LATVIJAS PAGAIDU AIZSARDZIBA",0,0,0,0,0
"AMATAS NOVADS","LATVIJAS NEPILSONIS",0,187,0,2,189
"AMATAS NOVADS","LATVIJAS BEGLIS",0,0,0,0,0
"AMATAS NOVADS","LATVIJAS BEZVALSTNIEKS",0,0,0,0,0
"AMATAS NOVADS","LATVIJAS ALTERNATIVAIS",0,0,0,0,0
"AMATAS NOVADS","PAREJIE",0,87,0,0,87
"APES NOVADS","LATVIJAS PILSONIS",1,3474,2,19,3496
"APES NOVADS","LATVIJAS PAGAIDU AIZSARDZIBA",0,0,0,0,0
"APES NOVADS","LATVIJAS NEPILSONIS",0,107,0,0,107
"APES NOVADS","LATVIJAS BEGLIS",0,0,0,0,0
"APES NOVADS","LATVIJAS BEZVALSTNIEKS",0,0,0,0,0
"APES NOVADS","LATVIJAS ALTERNATIVAIS",0,0,0,0,0
"APES NOVADS","PAREJIE",0,15,0,0,15
"AUCES NOVADS","LATVIJAS PILSONIS",2,6457,0,57,6516
"AUCES NOVADS","LATVIJAS PAGAIDU AIZSARDZIBA",0,0,0,0,0
"AUCES NOVADS","LATVIJAS NEPILSONIS",0,602,0,20,622
"AUCES NOVADS","LATVIJAS BEGLIS",0,0,0,0,0
"AUCES NOVADS","LATVIJAS BEZVALSTNIEKS",0,2,0,0,2
"AUCES NOVADS","LATVIJAS ALTERNATIVAIS",0,0,0,0,0
"AUCES NOVADS","PAREJIE",0,46,0,5,51
"ADAZU NOVADS","LATVIJAS PILSONIS",2,10364,0,106,10472
"ADAZU NOVADS","LATVIJAS PAGAIDU AIZSARDZIBA",0,0,0,0,0
"ADAZU NOVADS","LATVIJAS NEPILSONIS",0,744,0,27,771
"ADAZU NOVADS","LATVIJAS BEGLIS",0,0,0,0,0
"ADAZU NOVADS","LATVIJAS BEZVALSTNIEKS",0,1,0,0,1
"ADAZU NOVADS","LATVIJAS ALTERNATIVAIS",0,0,0,0,0
"ADAZU NOVADS","PAREJIE",1,431,0,8,440
"BABITES NOVADS","LATVIJAS PILSONIS",0,9509,0,75,9584
"BABITES NOVADS","LATVIJAS PAGAIDU AIZSARDZIBA",0,0,0,0,0
"BABITES NOVADS","LATVIJAS NEPILSONIS",0,725,0,15,740
"BABITES NOVADS","LATVIJAS BEGLIS",0,0,0,0,0
"BABITES NOVADS","LATVIJAS BEZVALSTNIEKS",0,0,0,0,0
"BABITES NOVADS","LATVIJAS ALTERNATIVAIS",0,0,0,0,0
"BABITES NOVADS","PAREJIE",4,826,0,5,835
"BALDONES NOVADS","LATVIJAS PILSONIS",1,5336,0,81,5418
"BALDONES NOVADS","LATVIJAS PAGAIDU AIZSARDZIBA",0,0,0,0,0
"BALDONES NOVADS","LATVIJAS NEPILSONIS",0,272,0,12,284
"BALDONES NOVADS","LATVIJAS BEGLIS",0,0,0,0,0
"BALDONES NOVADS","LATVIJAS BEZVALSTNIEKS",0,0,0,0,0
"BALDONES NOVADS","LATVIJAS ALTERNATIVAIS",0,0,0,0,0
"BALDONES NOVADS","PAREJIE",0,49,0,1,50
"BALTINAVAS NOVADS","LATVIJAS PILSONIS",0,1078,0,2,1080
"BALTINAVAS NOVADS","LATVIJAS PAGAIDU AIZSARDZIBA",0,0,0,0,0
"BALTINAVAS NOVADS","LATVIJAS NEPILSONIS",0,17,0,0,17
"BALTINAVAS NOVADS","LATVIJAS BEGLIS",0,0,0,0,0
"BALTINAVAS NOVADS","LATVIJAS BEZVALSTNIEKS",0,0,0,0,0
"BALTINAVAS NOVADS","LATVIJAS ALTERNATIVAIS",0,0,0,0,0
"BALTINAVAS NOVADS","PAREJIE",0,8,0,2,10
"BALVU NOVADS","LATVIJAS PILSONIS",0,12567,6,99,12672
"BALVU NOVADS","LATVIJAS PAGAIDU AIZSARDZIBA",0,0,0,0,0
"BALVU NOVADS","LATVIJAS NEPILSONIS",0,370,0,24,394
"BALVU NOVADS","LATVIJAS BEGLIS",0,0,0,0,0
"BALVU NOVADS","LATVIJAS BEZVALSTNIEKS",0,0,0,0,0
"BALVU NOVADS","LATVIJAS ALTERNATIVAIS",0,0,0,0,0
"BALVU NOVADS","PAREJIE",0,77,0,3,80
"BAUSKAS NOVADS","LATVIJAS PILSONIS",1,22200,1,250,22452
"BAUSKAS NOVADS","LATVIJAS PAGAIDU AIZSARDZIBA",0,0,0,0,0
"BAUSKAS NOVADS","LATVIJAS NEPILSONIS",0,1776,0,57,1833
"BAUSKAS NOVADS","LATVIJAS BEGLIS",0,0,0,0,0
"BAUSKAS NOVADS","LATVIJAS BEZVALSTNIEKS",0,1,0,0,1
"BAUSKAS NOVADS","LATVIJAS ALTERNATIVAIS",0,0,0,0,0
"BAUSKAS NOVADS","PAREJIE",1,309,0,1,311
"BEVERINAS NOVADS","LATVIJAS PILSONIS",0,2997,2,20,3019
"BEVERINAS NOVADS","LATVIJAS PAGAIDU AIZSARDZIBA",0,0,0,0,0
"BEVERINAS NOVADS","LATVIJAS NEPILSONIS",0,149,0,1,150
"BEVERINAS NOVADS","LATVIJAS BEGLIS",0,0,0,0,0
"BEVERINAS NOVADS","LATVIJAS BEZVALSTNIEKS",0,0,0,0,0
"BEVERINAS NOVADS","LATVIJAS ALTERNATIVAIS",0,0,0,0,0
"BEVERINAS NOVADS","PAREJIE",0,18,0,0,18
"BROCENU NOVADS","LATVIJAS PILSONIS",0,5749,0,65,5814
"BROCENU NOVADS","LATVIJAS PAGAIDU AIZSARDZIBA",0,0,0,0,0
"BROCENU NOVADS","LATVIJAS NEPILSONIS",0,344,0,35,379
"BROCENU NOVADS","LATVIJAS BEGLIS",0,0,0,0,0
"BROCENU NOVADS","LATVIJAS BEZVALSTNIEKS",0,0,0,0,0
"BROCENU NOVADS","LATVIJAS ALTERNATIVAIS",0,0,0,0,0
"BROCENU NOVADS","PAREJIE",0,59,0,2,61
"BURTNIEKU NOVADS","LATVIJAS PILSONIS",17,7175,0,71,7263
"BURTNIEKU NOVADS","LATVIJAS PAGAIDU AIZSARDZIBA",0,0,0,0,0
"BURTNIEKU NOVADS","LATVIJAS NEPILSONIS",9,383,0,15,407
"BURTNIEKU NOVADS","LATVIJAS BEGLIS",0,0,0,0,0
"BURTNIEKU NOVADS","LATVIJAS BEZVALSTNIEKS",0,0,0,0,0
"BURTNIEKU NOVADS","LATVIJAS ALTERNATIVAIS",0,0,0,0,0
"BURTNIEKU NOVADS","PAREJIE",1,40,0,0,41
"CARNIKAVAS NOVADS","LATVIJAS PILSONIS",5,7681,0,74,7760
"CARNIKAVAS NOVADS","LATVIJAS PAGAIDU AIZSARDZIBA",0,0,0,0,0
"CARNIKAVAS NOVADS","LATVIJAS NEPILSONIS",0,1026,0,21,1047
"CARNIKAVAS NOVADS","LATVIJAS BEGLIS",1,1,0,0,2
"CARNIKAVAS NOVADS","LATVIJAS BEZVALSTNIEKS",0,1,0,0,1
"CARNIKAVAS NOVADS","LATVIJAS ALTERNATIVAIS",0,0,0,0,0
"CARNIKAVAS NOVADS","PAREJIE",0,365,0,33,398
"CESVAINES NOVADS","LATVIJAS PILSONIS",0,2529,7,4,2540
"CESVAINES NOVADS","LATVIJAS PAGAIDU AIZSARDZIBA",0,0,0,0,0
"CESVAINES NOVADS","LATVIJAS NEPILSONIS",0,54,0,1,55
"CESVAINES NOVADS","LATVIJAS BEGLIS",0,0,0,0,0
"CESVAINES NOVADS","LATVIJAS BEZVALSTNIEKS",0,0,0,0,0
"CESVAINES NOVADS","LATVIJAS ALTERNATIVAIS",0,0,0,0,0
"CESVAINES NOVADS","PAREJIE",1,5,0,0,6
"CESU NOVADS","LATVIJAS PILSONIS",1,16980,0,342,17323
"CESU NOVADS","LATVIJAS PAGAIDU AIZSARDZIBA",0,0,0,0,0
"CESU NOVADS","LATVIJAS NEPILSONIS",1,652,0,55,708
"CESU NOVADS","LATVIJAS BEGLIS",0,1,0,0,1
"CESU NOVADS","LATVIJAS BEZVALSTNIEKS",0,0,0,0,0
"CESU NOVADS","LATVIJAS ALTERNATIVAIS",0,0,0,0,0
"CESU NOVADS","PAREJIE",2,387,0,2,391
"CIBLAS NOVADS","LATVIJAS PILSONIS",1,2589,0,8,2598
"CIBLAS NOVADS","LATVIJAS PAGAIDU AIZSARDZIBA",0,0,0,0,0
"CIBLAS NOVADS","LATVIJAS NEPILSONIS",1,123,0,6,130
"CIBLAS NOVADS","LATVIJAS BEGLIS",0,0,0,0,0
"CIBLAS NOVADS","LATVIJAS BEZVALSTNIEKS",0,0,0,0,0
"CIBLAS NOVADS","LATVIJAS ALTERNATIVAIS",0,0,0,0,0
"CIBLAS NOVADS","PAREJIE",0,37,0,0,37
"DAGDAS NOVADS","LATVIJAS PILSONIS",2,6896,1,39,6938
"DAGDAS NOVADS","LATVIJAS PAGAIDU AIZSARDZIBA",0,0,0,0,0
"DAGDAS NOVADS","LATVIJAS NEPILSONIS",0,542,1,6,549
"DAGDAS NOVADS","LATVIJAS BEGLIS",0,0,0,0,0
"DAGDAS NOVADS","LATVIJAS BEZVALSTNIEKS",0,0,0,0,0
"DAGDAS NOVADS","LATVIJAS ALTERNATIVAIS",0,0,0,0,0
"DAGDAS NOVADS","PAREJIE",0,121,0,0,121
"DAUGAVPILS NOVADS","LATVIJAS PILSONIS",1,19494,3,180,19678
"DAUGAVPILS NOVADS","LATVIJAS PAGAIDU AIZSARDZIBA",0,0,0,0,0
"DAUGAVPILS NOVADS","LATVIJAS NEPILSONIS",0,2677,0,45,2722
"DAUGAVPILS NOVADS","LATVIJAS BEGLIS",0,0,0,0,0
"DAUGAVPILS NOVADS","LATVIJAS BEZVALSTNIEKS",0,1,0,0,1
"DAUGAVPILS NOVADS","LATVIJAS ALTERNATIVAIS",0,0,0,0,0
"DAUGAVPILS NOVADS","PAREJIE",0,832,0,3,835
"DOBELES NOVADS","LATVIJAS PILSONIS",0,18762,1,288,19051
"DOBELES NOVADS","LATVIJAS PAGAIDU AIZSARDZIBA",0,0,0,0,0
"DOBELES NOVADS","LATVIJAS NEPILSONIS",0,1916,0,44,1960
"DOBELES NOVADS","LATVIJAS BEGLIS",0,0,0,0,0
"DOBELES NOVADS","LATVIJAS BEZVALSTNIEKS",0,2,0,0,2
"DOBELES NOVADS","LATVIJAS ALTERNATIVAIS",0,0,0,0,0
"DOBELES NOVADS","PAREJIE",0,294,0,17,311
"DUNDAGAS NOVADS","LATVIJAS PILSONIS",2,3973,1,23,3999
"DUNDAGAS NOVADS","LATVIJAS PAGAIDU AIZSARDZIBA",0,0,0,0,0
"DUNDAGAS NOVADS","LATVIJAS NEPILSONIS",0,56,0,0,56
"DUNDAGAS NOVADS","LATVIJAS BEGLIS",0,0,0,0,0
"DUNDAGAS NOVADS","LATVIJAS BEZVALSTNIEKS",0,0,0,0,0
"DUNDAGAS NOVADS","LATVIJAS ALTERNATIVAIS",0,0,0,0,0
"DUNDAGAS NOVADS","PAREJIE",0,15,0,1,16
"DURBES NOVADS","LATVIJAS PILSONIS",0,2798,1,24,2823
"DURBES NOVADS","LATVIJAS PAGAIDU AIZSARDZIBA",0,0,0,0,0
"DURBES NOVADS","LATVIJAS NEPILSONIS",0,74,0,1,75
"DURBES NOVADS","LATVIJAS BEGLIS",0,0,0,0,0
"DURBES NOVADS","LATVIJAS BEZVALSTNIEKS",0,0,0,0,0
"DURBES NOVADS","LATVIJAS ALTERNATIVAIS",0,0,0,0,0
"DURBES NOVADS","PAREJIE",0,13,0,0,13
"ENGURES NOVADS","LATVIJAS PILSONIS",2,6991,0,48,7041
"ENGURES NOVADS","LATVIJAS PAGAIDU AIZSARDZIBA",0,0,0,0,0
"ENGURES NOVADS","LATVIJAS NEPILSONIS",0,261,0,12,273
"ENGURES NOVADS","LATVIJAS BEGLIS",0,1,0,0,1
"ENGURES NOVADS","LATVIJAS BEZVALSTNIEKS",0,0,0,0,0
"ENGURES NOVADS","LATVIJAS ALTERNATIVAIS",0,0,0,0,0
"ENGURES NOVADS","PAREJIE",0,121,0,5,126
"ERGLU NOVADS","LATVIJAS PILSONIS",0,2900,2,17,2919
"ERGLU NOVADS","LATVIJAS PAGAIDU AIZSARDZIBA",0,0,0,0,0
"ERGLU NOVADS","LATVIJAS NEPILSONIS",0,65,0,6,71
"ERGLU NOVADS","LATVIJAS BEGLIS",0,0,0,0,0
"ERGLU NOVADS","LATVIJAS BEZVALSTNIEKS",0,1,0,0,1
"ERGLU NOVADS","LATVIJAS ALTERNATIVAIS",0,0,0,0,0
"ERGLU NOVADS","PAREJIE",0,61,0,0,61
"GARKALNES NOVADS","LATVIJAS PILSONIS",2,7543,0,41,7586
"GARKALNES NOVADS","LATVIJAS PAGAIDU AIZSARDZIBA",0,0,0,0,0
"GARKALNES NOVADS","LATVIJAS NEPILSONIS",0,674,0,24,698
"GARKALNES NOVADS","LATVIJAS BEGLIS",0,0,0,0,0
"GARKALNES NOVADS","LATVIJAS BEZVALSTNIEKS",0,1,0,0,1
"GARKALNES NOVADS","LATVIJAS ALTERNATIVAIS",0,0,0,0,0
"GARKALNES NOVADS","PAREJIE",0,580,0,14,594
"GROBINAS NOVADS","LATVIJAS PILSONIS",0,8536,2,116,8654
"GROBINAS NOVADS","LATVIJAS PAGAIDU AIZSARDZIBA",0,0,0,0,0
"GROBINAS NOVADS","LATVIJAS NEPILSONIS",0,367,0,11,378
"GROBINAS NOVADS","LATVIJAS BEGLIS",0,0,0,0,0
"GROBINAS NOVADS","LATVIJAS BEZVALSTNIEKS",0,0,0,0,0
"GROBINAS NOVADS","LATVIJAS ALTERNATIVAIS",0,0,0,0,0
"GROBINAS NOVADS","PAREJIE",0,145,0,1,146
"GULBENES NOVADS","LATVIJAS PILSONIS",2,20879,3,191,21075
"GULBENES NOVADS","LATVIJAS PAGAIDU AIZSARDZIBA",0,0,0,0,0
"GULBENES NOVADS","LATVIJAS NEPILSONIS",0,704,0,23,727
"GULBENES NOVADS","LATVIJAS BEGLIS",0,0,0,0,0
"GULBENES NOVADS","LATVIJAS BEZVALSTNIEKS",0,1,0,0,1
"GULBENES NOVADS","LATVIJAS ALTERNATIVAIS",0,0,0,0,0
"GULBENES NOVADS","PAREJIE",0,154,0,0,154
"IECAVAS NOVADS","LATVIJAS PILSONIS",0,7870,0,108,7978
"IECAVAS NOVADS","LATVIJAS PAGAIDU AIZSARDZIBA",0,0,0,0,0
"IECAVAS NOVADS","LATVIJAS NEPILSONIS",0,847,0,29,876
"IECAVAS NOVADS","LATVIJAS BEGLIS",0,0,0,0,0
"IECAVAS NOVADS","LATVIJAS BEZVALSTNIEKS",0,0,0,0,0
"IECAVAS NOVADS","LATVIJAS ALTERNATIVAIS",0,0,0,0,0
"IECAVAS NOVADS","PAREJIE",2,203,0,3,208
"IKSKILES NOVADS","LATVIJAS PILSONIS",3,9475,1,78,9557
"IKSKILES NOVADS","LATVIJAS PAGAIDU AIZSARDZIBA",0,0,0,0,0
"IKSKILES NOVADS","LATVIJAS NEPILSONIS",0,265,0,16,281
"IKSKILES NOVADS","LATVIJAS BEGLIS",0,0,0,0,0
"IKSKILES NOVADS","LATVIJAS BEZVALSTNIEKS",0,1,0,0,1
"IKSKILES NOVADS","LATVIJAS ALTERNATIVAIS",0,0,0,0,0
"IKSKILES NOVADS","PAREJIE",0,138,0,11,149
"ILUKSTES NOVADS","LATVIJAS PILSONIS",0,6814,0,43,6857
"ILUKSTES NOVADS","LATVIJAS PAGAIDU AIZSARDZIBA",0,0,0,0,0
"ILUKSTES NOVADS","LATVIJAS NEPILSONIS",0,535,0,4,539
"ILUKSTES NOVADS","LATVIJAS BEGLIS",0,0,0,0,0
"ILUKSTES NOVADS","LATVIJAS BEZVALSTNIEKS",0,2,0,0,2
"ILUKSTES NOVADS","LATVIJAS ALTERNATIVAIS",0,0,0,0,0
"ILUKSTES NOVADS","PAREJIE",0,116,0,0,116
"INCUKALNA NOVADS","LATVIJAS PILSONIS",0,6514,2,138,6654
"INCUKALNA NOVADS","LATVIJAS PAGAIDU AIZSARDZIBA",0,0,0,0,0
"INCUKALNA NOVADS","LATVIJAS NEPILSONIS",0,1119,1,53,1173
"INCUKALNA NOVADS","LATVIJAS BEGLIS",0,0,0,0,0
"INCUKALNA NOVADS","LATVIJAS BEZVALSTNIEKS",0,0,0,0,0
"INCUKALNA NOVADS","LATVIJAS ALTERNATIVAIS",0,0,0,0,0
"INCUKALNA NOVADS","PAREJIE",2,276,0,6,284
"JAUNJELGAVAS NOVADS","LATVIJAS PILSONIS",1,5301,1,40,5343
"JAUNJELGAVAS NOVADS","LATVIJAS PAGAIDU AIZSARDZIBA",0,0,0,0,0
"JAUNJELGAVAS NOVADS","LATVIJAS NEPILSONIS",0,322,1,43,366
"JAUNJELGAVAS NOVADS","LATVIJAS BEGLIS",0,0,0,0,0
"JAUNJELGAVAS NOVADS","LATVIJAS BEZVALSTNIEKS",0,0,0,0,0
"JAUNJELGAVAS NOVADS","LATVIJAS ALTERNATIVAIS",0,0,0,0,0
"JAUNJELGAVAS NOVADS","PAREJIE",0,35,0,0,35
"JAUNPIEBALGAS NOVADS","LATVIJAS PILSONIS",0,2224,2,18,2244
"JAUNPIEBALGAS NOVADS","LATVIJAS PAGAIDU AIZSARDZIBA",0,0,0,0,0
"JAUNPIEBALGAS NOVADS","LATVIJAS NEPILSONIS",0,37,0,1,38
"JAUNPIEBALGAS NOVADS","LATVIJAS BEGLIS",0,0,0,0,0
"JAUNPIEBALGAS NOVADS","LATVIJAS BEZVALSTNIEKS",0,0,0,0,0
"JAUNPIEBALGAS NOVADS","LATVIJAS ALTERNATIVAIS",0,0,0,0,0
"JAUNPIEBALGAS NOVADS","PAREJIE",0,11,0,0,11
"JAUNPILS NOVADS","LATVIJAS PILSONIS",0,2333,0,8,2341
"JAUNPILS NOVADS","LATVIJAS PAGAIDU AIZSARDZIBA",0,0,0,0,0
"JAUNPILS NOVADS","LATVIJAS NEPILSONIS",0,64,0,1,65
"JAUNPILS NOVADS","LATVIJAS BEGLIS",0,0,0,0,0
"JAUNPILS NOVADS","LATVIJAS BEZVALSTNIEKS",0,0,0,0,0
"JAUNPILS NOVADS","LATVIJAS ALTERNATIVAIS",0,0,0,0,0
"JAUNPILS NOVADS","PAREJIE",0,12,0,0,12
"JELGAVAS NOVADS","LATVIJAS PILSONIS",2,20466,1,328,20797
"JELGAVAS NOVADS","LATVIJAS PAGAIDU AIZSARDZIBA",0,0,0,0,0
"JELGAVAS NOVADS","LATVIJAS NEPILSONIS",0,2731,2,87,2820
"JELGAVAS NOVADS","LATVIJAS BEGLIS",0,0,0,0,0
"JELGAVAS NOVADS","LATVIJAS BEZVALSTNIEKS",0,0,0,0,0
"JELGAVAS NOVADS","LATVIJAS ALTERNATIVAIS",0,0,0,0,0
"JELGAVAS NOVADS","PAREJIE",0,310,0,10,320
"JEKABPILS NOVADS","LATVIJAS PILSONIS",0,4563,3,35,4601
"JEKABPILS NOVADS","LATVIJAS PAGAIDU AIZSARDZIBA",0,0,0,0,0
"JEKABPILS NOVADS","LATVIJAS NEPILSONIS",0,121,0,4,125
"JEKABPILS NOVADS","LATVIJAS BEGLIS",0,0,0,0,0
"JEKABPILS NOVADS","LATVIJAS BEZVALSTNIEKS",0,0,0,0,0
"JEKABPILS NOVADS","LATVIJAS ALTERNATIVAIS",0,0,0,0,0
"JEKABPILS NOVADS","PAREJIE",0,17,0,1,18
"KANDAVAS NOVADS","LATVIJAS PILSONIS",2,8122,3,97,8224
"KANDAVAS NOVADS","LATVIJAS PAGAIDU AIZSARDZIBA",0,0,0,0,0
"KANDAVAS NOVADS","LATVIJAS NEPILSONIS",0,192,0,3,195
"KANDAVAS NOVADS","LATVIJAS BEGLIS",0,0,0,0,0
"KANDAVAS NOVADS","LATVIJAS BEZVALSTNIEKS",0,0,0,0,0
"KANDAVAS NOVADS","LATVIJAS ALTERNATIVAIS",0,0,0,0,0
"KANDAVAS NOVADS","PAREJIE",0,52,0,2,54
"KARSAVAS NOVADS","LATVIJAS PILSONIS",2,5475,0,34,5511
"KARSAVAS NOVADS","LATVIJAS PAGAIDU AIZSARDZIBA",0,0,0,0,0
"KARSAVAS NOVADS","LATVIJAS NEPILSONIS",0,221,0,7,228
"KARSAVAS NOVADS","LATVIJAS BEGLIS",0,0,0,0,0
"KARSAVAS NOVADS","LATVIJAS BEZVALSTNIEKS",0,0,0,0,0
"KARSAVAS NOVADS","LATVIJAS ALTERNATIVAIS",0,0,0,0,0
"KARSAVAS NOVADS","PAREJIE",0,55,0,0,55
"KOCENU NOVADS","LATVIJAS PILSONIS",0,5896,6,55,5957
"KOCENU NOVADS","LATVIJAS PAGAIDU AIZSARDZIBA",0,0,0,0,0
"KOCENU NOVADS","LATVIJAS NEPILSONIS",0,317,0,10,327
"KOCENU NOVADS","LATVIJAS BEGLIS",0,0,0,0,0
"KOCENU NOVADS","LATVIJAS BEZVALSTNIEKS",0,0,0,0,0
"KOCENU NOVADS","LATVIJAS ALTERNATIVAIS",0,0,0,0,0
"KOCENU NOVADS","PAREJIE",0,21,0,1,22
"KOKNESES NOVADS","LATVIJAS PILSONIS",1,5148,0,59,5208
"KOKNESES NOVADS","LATVIJAS PAGAIDU AIZSARDZIBA",0,0,0,0,0
"KOKNESES NOVADS","LATVIJAS NEPILSONIS",0,153,0,19,172
"KOKNESES NOVADS","LATVIJAS BEGLIS",0,0,0,0,0
"KOKNESES NOVADS","LATVIJAS BEZVALSTNIEKS",0,1,0,0,1
"KOKNESES NOVADS","LATVIJAS ALTERNATIVAIS",0,0,0,0,0
"KOKNESES NOVADS","PAREJIE",0,26,0,1,27
"KRASLAVAS NOVADS","LATVIJAS PILSONIS",4,13649,9,195,13857
"KRASLAVAS NOVADS","LATVIJAS PAGAIDU AIZSARDZIBA",0,0,0,0,0
"KRASLAVAS NOVADS","LATVIJAS NEPILSONIS",0,1898,0,64,1962
"KRASLAVAS NOVADS","LATVIJAS BEGLIS",0,0,0,0,0
"KRASLAVAS NOVADS","LATVIJAS BEZVALSTNIEKS",0,1,0,0,1
"KRASLAVAS NOVADS","LATVIJAS ALTERNATIVAIS",0,0,0,0,0
"KRASLAVAS NOVADS","PAREJIE",0,555,0,10,565
"KRIMULDAS NOVADS","LATVIJAS PILSONIS",1,5027,1,20,5049
"KRIMULDAS NOVADS","LATVIJAS PAGAIDU AIZSARDZIBA",0,0,0,0,0
"KRIMULDAS NOVADS","LATVIJAS NEPILSONIS",0,112,0,2,114
"KRIMULDAS NOVADS","LATVIJAS BEGLIS",0,0,0,0,0
"KRIMULDAS NOVADS","LATVIJAS BEZVALSTNIEKS",0,1,0,0,1
"KRIMULDAS NOVADS","LATVIJAS ALTERNATIVAIS",0,0,0,0,0
"KRIMULDAS NOVADS","PAREJIE",1,29,0,0,30
"KRUSTPILS NOVADS","LATVIJAS PILSONIS",0,5585,0,40,5625
"KRUSTPILS NOVADS","LATVIJAS PAGAIDU AIZSARDZIBA",0,0,0,0,0
"KRUSTPILS NOVADS","LATVIJAS NEPILSONIS",0,371,0,7,378
"KRUSTPILS NOVADS","LATVIJAS BEGLIS",0,0,0,0,0
"KRUSTPILS NOVADS","LATVIJAS BEZVALSTNIEKS",0,2,0,0,2
"KRUSTPILS NOVADS","LATVIJAS ALTERNATIVAIS",0,0,0,0,0
"KRUSTPILS NOVADS","PAREJIE",0,47,0,0,47
"KULDIGAS NOVADS","LATVIJAS PILSONIS",0,23204,1,425,23630
"KULDIGAS NOVADS","LATVIJAS PAGAIDU AIZSARDZIBA",0,0,0,0,0
"KULDIGAS NOVADS","LATVIJAS NEPILSONIS",0,446,0,22,468
"KULDIGAS NOVADS","LATVIJAS BEGLIS",0,0,0,0,0
"KULDIGAS NOVADS","LATVIJAS BEZVALSTNIEKS",0,1,0,0,1
"KULDIGAS NOVADS","LATVIJAS ALTERNATIVAIS",0,0,0,0,0
"KULDIGAS NOVADS","PAREJIE",0,97,0,4,101
"KEGUMA NOVADS","LATVIJAS PILSONIS",1,5325,3,70,5399
"KEGUMA NOVADS","LATVIJAS PAGAIDU AIZSARDZIBA",0,0,0,0,0
"KEGUMA NOVADS","LATVIJAS NEPILSONIS",0,291,0,9,300
"KEGUMA NOVADS","LATVIJAS BEGLIS",0,0,0,0,0
"KEGUMA NOVADS","LATVIJAS BEZVALSTNIEKS",0,0,0,0,0
"KEGUMA NOVADS","LATVIJAS ALTERNATIVAIS",0,0,0,0,0
"KEGUMA NOVADS","PAREJIE",0,74,0,1,75
"KEKAVAS NOVADS","LATVIJAS PILSONIS",3,21319,3,172,21497
"KEKAVAS NOVADS","LATVIJAS PAGAIDU AIZSARDZIBA",0,0,0,0,0
"KEKAVAS NOVADS","LATVIJAS NEPILSONIS",1,1538,0,66,1605
"KEKAVAS NOVADS","LATVIJAS BEGLIS",0,5,0,0,5
"KEKAVAS NOVADS","LATVIJAS BEZVALSTNIEKS",0,2,0,0,2
"KEKAVAS NOVADS","LATVIJAS ALTERNATIVAIS",0,0,0,0,0
"KEKAVAS NOVADS","PAREJIE",4,589,0,14,607
"LIELVARDES NOVADS","LATVIJAS PILSONIS",1,9641,2,152,9796
"LIELVARDES NOVADS","LATVIJAS PAGAIDU AIZSARDZIBA",0,0,0,0,0
"LIELVARDES NOVADS","LATVIJAS NEPILSONIS",0,432,0,35,467
"LIELVARDES NOVADS","LATVIJAS BEGLIS",0,0,0,0,0
"LIELVARDES NOVADS","LATVIJAS BEZVALSTNIEKS",0,1,0,0,1
"LIELVARDES NOVADS","LATVIJAS ALTERNATIVAIS",0,0,0,0,0
"LIELVARDES NOVADS","PAREJIE",0,146,0,7,153
"LIMBAZU NOVADS","LATVIJAS PILSONIS",2,16682,2,109,16795
"LIMBAZU NOVADS","LATVIJAS PAGAIDU AIZSARDZIBA",0,0,0,0,0
"LIMBAZU NOVADS","LATVIJAS NEPILSONIS",0,506,0,18,524
"LIMBAZU NOVADS","LATVIJAS BEGLIS",0,0,0,0,0
"LIMBAZU NOVADS","LATVIJAS BEZVALSTNIEKS",0,1,0,0,1
"LIMBAZU NOVADS","LATVIJAS ALTERNATIVAIS",0,0,0,0,0
"LIMBAZU NOVADS","PAREJIE",1,145,0,2,148
"LIGATNES NOVADS","LATVIJAS PILSONIS",0,3300,0,42,3342
"LIGATNES NOVADS","LATVIJAS PAGAIDU AIZSARDZIBA",0,0,0,0,0
"LIGATNES NOVADS","LATVIJAS NEPILSONIS",0,116,0,3,119
"LIGATNES NOVADS","LATVIJAS BEGLIS",0,0,0,0,0
"LIGATNES NOVADS","LATVIJAS BEZVALSTNIEKS",0,0,0,0,0
"LIGATNES NOVADS","LATVIJAS ALTERNATIVAIS",0,0,0,0,0
"LIGATNES NOVADS","PAREJIE",0,45,0,1,46
"LIVANU NOVADS","LATVIJAS PILSONIS",2,11229,1,137,11369
"LIVANU NOVADS","LATVIJAS PAGAIDU AIZSARDZIBA",0,0,0,0,0
"LIVANU NOVADS","LATVIJAS NEPILSONIS",0,554,0,25,579
"LIVANU NOVADS","LATVIJAS BEGLIS",0,0,0,0,0
"LIVANU NOVADS","LATVIJAS BEZVALSTNIEKS",0,0,0,0,0
"LIVANU NOVADS","LATVIJAS ALTERNATIVAIS",0,0,0,1,1
"LIVANU NOVADS","PAREJIE",0,236,0,8,244
"LUBANAS NOVADS","LATVIJAS PILSONIS",0,2394,0,6,2400
"LUBANAS NOVADS","LATVIJAS PAGAIDU AIZSARDZIBA",0,0,0,0,0
"LUBANAS NOVADS","LATVIJAS NEPILSONIS",0,23,0,0,23
"LUBANAS NOVADS","LATVIJAS BEGLIS",0,0,0,0,0
"LUBANAS NOVADS","LATVIJAS BEZVALSTNIEKS",0,0,0,0,0
"LUBANAS NOVADS","LATVIJAS ALTERNATIVAIS",0,0,0,0,0
"LUBANAS NOVADS","PAREJIE",0,6,0,0,6
"LUDZAS NOVADS","LATVIJAS PILSONIS",2,12150,1,138,12291
"LUDZAS NOVADS","LATVIJAS PAGAIDU AIZSARDZIBA",0,0,0,0,0
"LUDZAS NOVADS","LATVIJAS NEPILSONIS",0,785,0,27,812
"LUDZAS NOVADS","LATVIJAS BEGLIS",0,0,0,0,0
"LUDZAS NOVADS","LATVIJAS BEZVALSTNIEKS",0,0,0,0,0
"LUDZAS NOVADS","LATVIJAS ALTERNATIVAIS",0,0,0,0,0
"LUDZAS NOVADS","PAREJIE",0,227,0,5,232
"MADONAS NOVADS","LATVIJAS PILSONIS",1,23240,4,246,23491
"MADONAS NOVADS","LATVIJAS PAGAIDU AIZSARDZIBA",0,0,0,0,0
"MADONAS NOVADS","LATVIJAS NEPILSONIS",0,767,1,42,810
"MADONAS NOVADS","LATVIJAS BEGLIS",0,0,0,0,0
"MADONAS NOVADS","LATVIJAS BEZVALSTNIEKS",0,0,0,0,0
"MADONAS NOVADS","LATVIJAS ALTERNATIVAIS",0,0,0,0,0
"MADONAS NOVADS","PAREJIE",0,148,1,2,151
"MAZSALACAS NOVADS","LATVIJAS PILSONIS",0,3116,7,27,3150
"MAZSALACAS NOVADS","LATVIJAS PAGAIDU AIZSARDZIBA",0,0,0,0,0
"MAZSALACAS NOVADS","LATVIJAS NEPILSONIS",0,107,0,2,109
"MAZSALACAS NOVADS","LATVIJAS BEGLIS",0,0,0,0,0
"MAZSALACAS NOVADS","LATVIJAS BEZVALSTNIEKS",0,0,0,0,0
"MAZSALACAS NOVADS","LATVIJAS ALTERNATIVAIS",0,0,0,0,0
"MAZSALACAS NOVADS","PAREJIE",0,8,0,0,8
"MALPILS NOVADS","LATVIJAS PILSONIS",0,3358,0,22,3380
"MALPILS NOVADS","LATVIJAS PAGAIDU AIZSARDZIBA",0,0,0,0,0
"MALPILS NOVADS","LATVIJAS NEPILSONIS",0,196,0,3,199
"MALPILS NOVADS","LATVIJAS BEGLIS",0,0,0,0,0
"MALPILS NOVADS","LATVIJAS BEZVALSTNIEKS",0,0,0,0,0
"MALPILS NOVADS","LATVIJAS ALTERNATIVAIS",0,0,0,0,0
"MALPILS NOVADS","PAREJIE",0,23,0,0,23
"MARUPES NOVADS","LATVIJAS PILSONIS",4,17920,2,142,18068
"MARUPES NOVADS","LATVIJAS PAGAIDU AIZSARDZIBA",0,0,0,0,0
"MARUPES NOVADS","LATVIJAS NEPILSONIS",0,1126,0,39,1165
"MARUPES NOVADS","LATVIJAS BEGLIS",0,1,0,0,1
"MARUPES NOVADS","LATVIJAS BEZVALSTNIEKS",0,1,0,0,1
"MARUPES NOVADS","LATVIJAS ALTERNATIVAIS",0,0,0,0,0
"MARUPES NOVADS","PAREJIE",10,1954,1,29,1994
"MERSRAGA NOVADS","LATVIJAS PILSONIS",1,1565,0,12,1578
"MERSRAGA NOVADS","LATVIJAS PAGAIDU AIZSARDZIBA",0,0,0,0,0
"MERSRAGA NOVADS","LATVIJAS NEPILSONIS",0,31,0,3,34
"MERSRAGA NOVADS","LATVIJAS BEGLIS",0,0,0,0,0
"MERSRAGA NOVADS","LATVIJAS BEZVALSTNIEKS",0,0,0,0,0
"MERSRAGA NOVADS","LATVIJAS ALTERNATIVAIS",0,0,0,0,0
"MERSRAGA NOVADS","PAREJIE",0,9,0,1,10
"NAUKSENU NOVADS","LATVIJAS PILSONIS",0,1818,0,24,1842
"NAUKSENU NOVADS","LATVIJAS PAGAIDU AIZSARDZIBA",0,0,0,0,0
"NAUKSENU NOVADS","LATVIJAS NEPILSONIS",0,30,0,1,31
"NAUKSENU NOVADS","LATVIJAS BEGLIS",0,0,0,0,0
"NAUKSENU NOVADS","LATVIJAS BEZVALSTNIEKS",0,0,0,0,0
"NAUKSENU NOVADS","LATVIJAS ALTERNATIVAIS",0,0,0,0,0
"NAUKSENU NOVADS","PAREJIE",0,2,0,0,2
"NERETAS NOVADS","LATVIJAS PILSONIS",0,3317,0,20,3337
"NERETAS NOVADS","LATVIJAS PAGAIDU AIZSARDZIBA",0,0,0,0,0
"NERETAS NOVADS","LATVIJAS NEPILSONIS",0,248,0,15,263
"NERETAS NOVADS","LATVIJAS BEGLIS",0,0,0,0,0
"NERETAS NOVADS","LATVIJAS BEZVALSTNIEKS",0,0,0,0,0
"NERETAS NOVADS","LATVIJAS ALTERNATIVAIS",0,0,0,0,0
"NERETAS NOVADS","PAREJIE",0,28,0,0,28
"NICAS NOVADS","LATVIJAS PILSONIS",0,3273,0,22,3295
"NICAS NOVADS","LATVIJAS PAGAIDU AIZSARDZIBA",0,0,0,0,0
"NICAS NOVADS","LATVIJAS NEPILSONIS",0,53,0,4,57
"NICAS NOVADS","LATVIJAS BEGLIS",0,0,0,0,0
"NICAS NOVADS","LATVIJAS BEZVALSTNIEKS",0,0,0,0,0
"NICAS NOVADS","LATVIJAS ALTERNATIVAIS",0,0,0,0,0
"NICAS NOVADS","PAREJIE",0,32,0,0,32
"OGRES NOVADS","LATVIJAS PILSONIS",3,31788,0,528,32319
"OGRES NOVADS","LATVIJAS PAGAIDU AIZSARDZIBA",0,0,0,0,0
"OGRES NOVADS","LATVIJAS NEPILSONIS",0,2313,0,157,2470
"OGRES NOVADS","LATVIJAS BEGLIS",0,0,0,0,0
"OGRES NOVADS","LATVIJAS BEZVALSTNIEKS",0,2,0,0,2
"OGRES NOVADS","LATVIJAS ALTERNATIVAIS",0,0,0,0,0
"OGRES NOVADS","PAREJIE",23,519,0,24,566
"OLAINES NOVADS","LATVIJAS PILSONIS",4,14794,2,280,15080
"OLAINES NOVADS","LATVIJAS PAGAIDU AIZSARDZIBA",0,0,0,0,0
"OLAINES NOVADS","LATVIJAS NEPILSONIS",1,4044,1,191,4237
"OLAINES NOVADS","LATVIJAS BEGLIS",0,0,0,0,0
"OLAINES NOVADS","LATVIJAS BEZVALSTNIEKS",0,2,0,0,2
"OLAINES NOVADS","LATVIJAS ALTERNATIVAIS",0,0,0,0,0
"OLAINES NOVADS","PAREJIE",1,842,0,14,857
"OZOLNIEKU NOVADS","LATVIJAS PILSONIS",0,9088,0,121,9209
"OZOLNIEKU NOVADS","LATVIJAS PAGAIDU AIZSARDZIBA",0,0,0,0,0
"OZOLNIEKU NOVADS","LATVIJAS NEPILSONIS",0,826,0,46,872
"OZOLNIEKU NOVADS","LATVIJAS BEGLIS",0,0,0,0,0
"OZOLNIEKU NOVADS","LATVIJAS BEZVALSTNIEKS",0,0,0,0,0
"OZOLNIEKU NOVADS","LATVIJAS ALTERNATIVAIS",0,0,0,0,0
"OZOLNIEKU NOVADS","PAREJIE",1,534,0,2,537
"PARGAUJAS NOVADS","LATVIJAS PILSONIS",0,3831,0,12,3843
"PARGAUJAS NOVADS","LATVIJAS PAGAIDU AIZSARDZIBA",0,0,0,0,0
"PARGAUJAS NOVADS","LATVIJAS NEPILSONIS",0,77,0,8,85
"PARGAUJAS NOVADS","LATVIJAS BEGLIS",0,0,0,0,0
"PARGAUJAS NOVADS","LATVIJAS BEZVALSTNIEKS",0,0,0,0,0
"PARGAUJAS NOVADS","LATVIJAS ALTERNATIVAIS",0,0,0,0,0
"PARGAUJAS NOVADS","PAREJIE",0,18,0,0,18
"PAVILOSTAS NOVADS","LATVIJAS PILSONIS",0,2693,0,9,2702
"PAVILOSTAS NOVADS","LATVIJAS PAGAIDU AIZSARDZIBA",0,0,0,0,0
"PAVILOSTAS NOVADS","LATVIJAS NEPILSONIS",0,83,0,1,84
"PAVILOSTAS NOVADS","LATVIJAS BEGLIS",0,0,0,0,0
"PAVILOSTAS NOVADS","LATVIJAS BEZVALSTNIEKS",0,0,0,0,0
"PAVILOSTAS NOVADS","LATVIJAS ALTERNATIVAIS",0,0,0,0,0
"PAVILOSTAS NOVADS","PAREJIE",0,25,0,0,25
"PLAVINU NOVADS","LATVIJAS PILSONIS",0,4830,5,90,4925
"PLAVINU NOVADS","LATVIJAS PAGAIDU AIZSARDZIBA",0,0,0,0,0
"PLAVINU NOVADS","LATVIJAS NEPILSONIS",0,377,0,16,393
"PLAVINU NOVADS","LATVIJAS BEGLIS",0,0,0,0,0
"PLAVINU NOVADS","LATVIJAS BEZVALSTNIEKS",0,0,0,0,0
"PLAVINU NOVADS","LATVIJAS ALTERNATIVAIS",0,0,0,0,0
"PLAVINU NOVADS","PAREJIE",0,51,1,1,53
"PREILU NOVADS","LATVIJAS PILSONIS",1,9563,0,95,9659
"PREILU NOVADS","LATVIJAS PAGAIDU AIZSARDZIBA",0,0,0,0,0
"PREILU NOVADS","LATVIJAS NEPILSONIS",0,262,0,14,276
"PREILU NOVADS","LATVIJAS BEGLIS",0,0,0,0,0
"PREILU NOVADS","LATVIJAS BEZVALSTNIEKS",0,0,0,0,0
"PREILU NOVADS","LATVIJAS ALTERNATIVAIS",0,0,0,0,0
"PREILU NOVADS","PAREJIE",0,90,0,0,90
"PRIEKULES NOVADS","LATVIJAS PILSONIS",0,5096,0,34,5130
"PRIEKULES NOVADS","LATVIJAS PAGAIDU AIZSARDZIBA",0,0,0,0,0
"PRIEKULES NOVADS","LATVIJAS NEPILSONIS",0,390,0,10,400
"PRIEKULES NOVADS","LATVIJAS BEGLIS",0,0,0,0,0
"PRIEKULES NOVADS","LATVIJAS BEZVALSTNIEKS",0,1,0,0,1
"PRIEKULES NOVADS","LATVIJAS ALTERNATIVAIS",0,0,0,0,0
"PRIEKULES NOVADS","PAREJIE",1,64,0,1,66
"PRIEKULU NOVADS","LATVIJAS PILSONIS",0,7634,1,117,7752
"PRIEKULU NOVADS","LATVIJAS PAGAIDU AIZSARDZIBA",0,0,0,0,0
"PRIEKULU NOVADS","LATVIJAS NEPILSONIS",0,564,0,38,602
"PRIEKULU NOVADS","LATVIJAS BEGLIS",0,0,0,0,0
"PRIEKULU NOVADS","LATVIJAS BEZVALSTNIEKS",0,0,0,0,0
"PRIEKULU NOVADS","LATVIJAS ALTERNATIVAIS",0,0,0,0,0
"PRIEKULU NOVADS","PAREJIE",0,98,0,1,99
"RAUNAS NOVADS","LATVIJAS PILSONIS",0,3122,0,34,3156
"RAUNAS NOVADS","LATVIJAS PAGAIDU AIZSARDZIBA",0,0,0,0,0
"RAUNAS NOVADS","LATVIJAS NEPILSONIS",0,109,0,1,110
"RAUNAS NOVADS","LATVIJAS BEGLIS",0,0,0,0,0
"RAUNAS NOVADS","LATVIJAS BEZVALSTNIEKS",0,0,0,0,0
"RAUNAS NOVADS","LATVIJAS ALTERNATIVAIS",0,0,0,0,0
"RAUNAS NOVADS","PAREJIE",0,3,0,0,3
"REZEKNES NOVADS","LATVIJAS PILSONIS",8,26094,3,157,26262
"REZEKNES NOVADS","LATVIJAS PAGAIDU AIZSARDZIBA",0,0,0,0,0
"REZEKNES NOVADS","LATVIJAS NEPILSONIS",0,939,0,22,961
"REZEKNES NOVADS","LATVIJAS BEGLIS",0,0,0,0,0
"REZEKNES NOVADS","LATVIJAS BEZVALSTNIEKS",0,1,0,0,1
"REZEKNES NOVADS","LATVIJAS ALTERNATIVAIS",0,0,0,0,0
"REZEKNES NOVADS","PAREJIE",1,275,0,0,276
"RIEBINU NOVADS","LATVIJAS PILSONIS",9,5016,0,31,5056
"RIEBINU NOVADS","LATVIJAS PAGAIDU AIZSARDZIBA",0,0,0,0,0
"RIEBINU NOVADS","LATVIJAS NEPILSONIS",0,139,0,2,141
"RIEBINU NOVADS","LATVIJAS BEGLIS",0,0,0,0,0
"RIEBINU NOVADS","LATVIJAS BEZVALSTNIEKS",0,0,0,0,0
"RIEBINU NOVADS","LATVIJAS ALTERNATIVAIS",0,0,0,0,0
"RIEBINU NOVADS","PAREJIE",0,39,0,0,39
"ROJAS NOVADS","LATVIJAS PILSONIS",0,3687,0,50,3737
"ROJAS NOVADS","LATVIJAS PAGAIDU AIZSARDZIBA",0,0,0,0,0
"ROJAS NOVADS","LATVIJAS NEPILSONIS",0,50,0,1,51
"ROJAS NOVADS","LATVIJAS BEGLIS",0,0,0,0,0
"ROJAS NOVADS","LATVIJAS BEZVALSTNIEKS",0,0,0,0,0
"ROJAS NOVADS","LATVIJAS ALTERNATIVAIS",0,0,0,0,0
"ROJAS NOVADS","PAREJIE",0,66,0,12,78
"ROPAZU NOVADS","LATVIJAS PILSONIS",0,6128,1,87,6216
"ROPAZU NOVADS","LATVIJAS PAGAIDU AIZSARDZIBA",0,0,0,0,0
"ROPAZU NOVADS","LATVIJAS NEPILSONIS",0,645,0,34,679
"ROPAZU NOVADS","LATVIJAS BEGLIS",30,0,0,0,30
"ROPAZU NOVADS","LATVIJAS BEZVALSTNIEKS",0,2,0,0,2
"ROPAZU NOVADS","LATVIJAS ALTERNATIVAIS",342,2,0,8,352
"ROPAZU NOVADS","PAREJIE",6,147,0,4,157
"RUCAVAS NOVADS","LATVIJAS PILSONIS",0,1616,0,3,1619
"RUCAVAS NOVADS","LATVIJAS PAGAIDU AIZSARDZIBA",0,0,0,0,0
"RUCAVAS NOVADS","LATVIJAS NEPILSONIS",0,40,0,4,44
"RUCAVAS NOVADS","LATVIJAS BEGLIS",0,0,0,0,0
"RUCAVAS NOVADS","LATVIJAS BEZVALSTNIEKS",0,0,0,0,0
"RUCAVAS NOVADS","LATVIJAS ALTERNATIVAIS",0,0,0,0,0
"RUCAVAS NOVADS","PAREJIE",0,24,0,0,24
"RUGAJU NOVADS","LATVIJAS PILSONIS",1,2199,0,3,2203
"RUGAJU NOVADS","LATVIJAS PAGAIDU AIZSARDZIBA",0,0,0,0,0
"RUGAJU NOVADS","LATVIJAS NEPILSONIS",0,34,0,0,34
"RUGAJU NOVADS","LATVIJAS BEGLIS",0,0,0,0,0
"RUGAJU NOVADS","LATVIJAS BEZVALSTNIEKS",0,0,0,0,0
"RUGAJU NOVADS","LATVIJAS ALTERNATIVAIS",0,0,0,0,0
"RUGAJU NOVADS","PAREJIE",0,6,0,0,6
"RUNDALES NOVADS","LATVIJAS PILSONIS",1,3223,0,31,3255
"RUNDALES NOVADS","LATVIJAS PAGAIDU AIZSARDZIBA",0,0,0,0,0
"RUNDALES NOVADS","LATVIJAS NEPILSONIS",0,457,0,13,470
"RUNDALES NOVADS","LATVIJAS BEGLIS",0,0,0,0,0
"RUNDALES NOVADS","LATVIJAS BEZVALSTNIEKS",0,1,0,0,1
"RUNDALES NOVADS","LATVIJAS ALTERNATIVAIS",0,0,0,0,0
"RUNDALES NOVADS","PAREJIE",1,28,0,0,29
"RUJIENAS NOVADS","LATVIJAS PILSONIS",1,5047,0,16,5064
"RUJIENAS NOVADS","LATVIJAS PAGAIDU AIZSARDZIBA",0,0,0,0,0
"RUJIENAS NOVADS","LATVIJAS NEPILSONIS",0,148,0,2,150
"RUJIENAS NOVADS","LATVIJAS BEGLIS",0,0,0,0,0
"RUJIENAS NOVADS","LATVIJAS BEZVALSTNIEKS",0,0,0,0,0
"RUJIENAS NOVADS","LATVIJAS ALTERNATIVAIS",0,0,0,0,0
"RUJIENAS NOVADS","PAREJIE",0,14,0,0,14
"SALACGRIVAS NOVADS","LATVIJAS PILSONIS",0,7681,7,52,7740
"SALACGRIVAS NOVADS","LATVIJAS PAGAIDU AIZSARDZIBA",0,0,0,0,0
"SALACGRIVAS NOVADS","LATVIJAS NEPILSONIS",0,224,0,10,234
"SALACGRIVAS NOVADS","LATVIJAS BEGLIS",0,0,0,0,0
"SALACGRIVAS NOVADS","LATVIJAS BEZVALSTNIEKS",0,0,0,0,0
"SALACGRIVAS NOVADS","LATVIJAS ALTERNATIVAIS",0,0,0,0,0
"SALACGRIVAS NOVADS","PAREJIE",0,50,0,0,50
"SALAS NOVADS","LATVIJAS PILSONIS",1,3451,1,33,3486
"SALAS NOVADS","LATVIJAS PAGAIDU AIZSARDZIBA",0,0,0,0,0
"SALAS NOVADS","LATVIJAS NEPILSONIS",0,221,0,12,233
"SALAS NOVADS","LATVIJAS BEGLIS",0,0,0,0,0
"SALAS NOVADS","LATVIJAS BEZVALSTNIEKS",0,0,0,0,0
"SALAS NOVADS","LATVIJAS ALTERNATIVAIS",0,0,0,0,0
"SALAS NOVADS","PAREJIE",0,22,0,0,22
"SALASPILS NOVADS","LATVIJAS PILSONIS",3,18207,2,202,18414
"SALASPILS NOVADS","LATVIJAS PAGAIDU AIZSARDZIBA",0,0,0,0,0
"SALASPILS NOVADS","LATVIJAS NEPILSONIS",0,4257,0,161,4418
"SALASPILS NOVADS","LATVIJAS BEGLIS",0,0,0,0,0
"SALASPILS NOVADS","LATVIJAS BEZVALSTNIEKS",0,1,0,0,1
"SALASPILS NOVADS","LATVIJAS ALTERNATIVAIS",0,0,0,0,0
"SALASPILS NOVADS","PAREJIE",0,867,0,7,874
"SALDUS NOVADS","LATVIJAS PILSONIS",0,23371,1,352,23724
"SALDUS NOVADS","LATVIJAS PAGAIDU AIZSARDZIBA",0,0,0,0,0
"SALDUS NOVADS","LATVIJAS NEPILSONIS",0,824,0,39,863
"SALDUS NOVADS","LATVIJAS BEGLIS",0,0,0,0,0
"SALDUS NOVADS","LATVIJAS BEZVALSTNIEKS",0,0,0,0,0
"SALDUS NOVADS","LATVIJAS ALTERNATIVAIS",0,0,0,0,0
"SALDUS NOVADS","PAREJIE",3,164,0,6,173
"SAULKRASTU NOVADS","LATVIJAS PILSONIS",2,5612,2,56,5672
"SAULKRASTU NOVADS","LATVIJAS PAGAIDU AIZSARDZIBA",0,0,0,0,0
"SAULKRASTU NOVADS","LATVIJAS NEPILSONIS",0,294,0,13,307
"SAULKRASTU NOVADS","LATVIJAS BEGLIS",0,0,0,0,0
"SAULKRASTU NOVADS","LATVIJAS BEZVALSTNIEKS",0,1,0,0,1
"SAULKRASTU NOVADS","LATVIJAS ALTERNATIVAIS",0,0,0,0,0
"SAULKRASTU NOVADS","PAREJIE",1,302,0,2,305
"SEJAS NOVADS","LATVIJAS PILSONIS",2,2225,0,11,2238
"SEJAS NOVADS","LATVIJAS PAGAIDU AIZSARDZIBA",0,0,0,0,0
"SEJAS NOVADS","LATVIJAS NEPILSONIS",0,90,0,2,92
"SEJAS NOVADS","LATVIJAS BEGLIS",0,0,0,0,0
"SEJAS NOVADS","LATVIJAS BEZVALSTNIEKS",0,0,0,0,0
"SEJAS NOVADS","LATVIJAS ALTERNATIVAIS",0,0,0,0,0
"SEJAS NOVADS","PAREJIE",0,22,0,0,22
"SIGULDAS NOVADS","LATVIJAS PILSONIS",6,17506,0,140,17652
"SIGULDAS NOVADS","LATVIJAS PAGAIDU AIZSARDZIBA",0,0,0,0,0
"SIGULDAS NOVADS","LATVIJAS NEPILSONIS",0,533,0,26,559
"SIGULDAS NOVADS","LATVIJAS BEGLIS",0,0,0,0,0
"SIGULDAS NOVADS","LATVIJAS BEZVALSTNIEKS",0,1,0,0,1
"SIGULDAS NOVADS","LATVIJAS ALTERNATIVAIS",0,0,0,0,0
"SIGULDAS NOVADS","PAREJIE",0,169,0,9,178
"SKRIVERU NOVADS","LATVIJAS PILSONIS",0,3426,0,28,3454
"SKRIVERU NOVADS","LATVIJAS PAGAIDU AIZSARDZIBA",0,0,0,0,0
"SKRIVERU NOVADS","LATVIJAS NEPILSONIS",0,92,0,17,109
"SKRIVERU NOVADS","LATVIJAS BEGLIS",0,0,0,0,0
"SKRIVERU NOVADS","LATVIJAS BEZVALSTNIEKS",0,0,0,0,0
"SKRIVERU NOVADS","LATVIJAS ALTERNATIVAIS",0,0,0,0,0
"SKRIVERU NOVADS","PAREJIE",0,28,0,2,30
"SKRUNDAS NOVADS","LATVIJAS PILSONIS",3,4797,0,65,4865
"SKRUNDAS NOVADS","LATVIJAS PAGAIDU AIZSARDZIBA",0,0,0,0,0
"SKRUNDAS NOVADS","LATVIJAS NEPILSONIS",0,183,0,11,194
"SKRUNDAS NOVADS","LATVIJAS BEGLIS",0,0,0,0,0
"SKRUNDAS NOVADS","LATVIJAS BEZVALSTNIEKS",0,0,0,0,0
"SKRUNDAS NOVADS","LATVIJAS ALTERNATIVAIS",0,0,0,0,0
"SKRUNDAS NOVADS","PAREJIE",0,40,0,1,41
"SMILTENES NOVADS","LATVIJAS PILSONIS",1,12492,0,69,12562
"SMILTENES NOVADS","LATVIJAS PAGAIDU AIZSARDZIBA",0,0,0,0,0
"SMILTENES NOVADS","LATVIJAS NEPILSONIS",0,185,0,2,187
"SMILTENES NOVADS","LATVIJAS BEGLIS",0,0,0,0,0
"SMILTENES NOVADS","LATVIJAS BEZVALSTNIEKS",0,0,0,0,0
"SMILTENES NOVADS","LATVIJAS ALTERNATIVAIS",0,0,0,0,0
"SMILTENES NOVADS","PAREJIE",1,34,0,7,42
"STOPINU NOVADS","LATVIJAS PILSONIS",0,9157,1,75,9233
"STOPINU NOVADS","LATVIJAS PAGAIDU AIZSARDZIBA",0,0,0,0,0
"STOPINU NOVADS","LATVIJAS NEPILSONIS",0,1297,0,33,1330
"STOPINU NOVADS","LATVIJAS BEGLIS",0,1,0,0,1
"STOPINU NOVADS","LATVIJAS BEZVALSTNIEKS",0,0,0,0,0
"STOPINU NOVADS","LATVIJAS ALTERNATIVAIS",0,0,0,0,0
"STOPINU NOVADS","PAREJIE",0,378,0,1,379
"STRENCU NOVADS","LATVIJAS PILSONIS",1,2717,0,45,2763
"STRENCU NOVADS","LATVIJAS PAGAIDU AIZSARDZIBA",0,0,0,0,0
"STRENCU NOVADS","LATVIJAS NEPILSONIS",0,496,0,14,510
"STRENCU NOVADS","LATVIJAS BEGLIS",0,0,0,0,0
"STRENCU NOVADS","LATVIJAS BEZVALSTNIEKS",0,1,0,0,1
"STRENCU NOVADS","LATVIJAS ALTERNATIVAIS",0,0,0,0,0
"STRENCU NOVADS","PAREJIE",0,68,0,0,68
"TALSU NOVADS","LATVIJAS PILSONIS",0,29485,0,457,29942
"TALSU NOVADS","LATVIJAS PAGAIDU AIZSARDZIBA",0,0,0,0,0
"TALSU NOVADS","LATVIJAS NEPILSONIS",0,612,0,13,625
"TALSU NOVADS","LATVIJAS BEGLIS",0,0,0,0,0
"TALSU NOVADS","LATVIJAS BEZVALSTNIEKS",0,7,0,0,7
"TALSU NOVADS","LATVIJAS ALTERNATIVAIS",0,0,0,0,0
"TALSU NOVADS","PAREJIE",1,141,0,4,146
"TERVETES NOVADS","LATVIJAS PILSONIS",0,3160,0,19,3179
"TERVETES NOVADS","LATVIJAS PAGAIDU AIZSARDZIBA",0,0,0,0,0
"TERVETES NOVADS","LATVIJAS NEPILSONIS",0,292,0,10,302
"TERVETES NOVADS","LATVIJAS BEGLIS",0,0,0,0,0
"TERVETES NOVADS","LATVIJAS BEZVALSTNIEKS",0,0,0,0,0
"TERVETES NOVADS","LATVIJAS ALTERNATIVAIS",0,0,0,0,0
"TERVETES NOVADS","PAREJIE",0,23,0,1,24
"TUKUMA NOVADS","LATVIJAS PILSONIS",7,28072,31,441,28551
"TUKUMA NOVADS","LATVIJAS PAGAIDU AIZSARDZIBA",0,0,0,0,0
"TUKUMA NOVADS","LATVIJAS NEPILSONIS",0,1368,3,83,1454
"TUKUMA NOVADS","LATVIJAS BEGLIS",0,0,0,0,0
"TUKUMA NOVADS","LATVIJAS BEZVALSTNIEKS",0,5,0,0,5
"TUKUMA NOVADS","LATVIJAS ALTERNATIVAIS",0,0,0,0,0
"TUKUMA NOVADS","PAREJIE",1,321,0,11,333
"VAINODES NOVADS","LATVIJAS PILSONIS",0,2323,0,14,2337
"VAINODES NOVADS","LATVIJAS PAGAIDU AIZSARDZIBA",0,0,0,0,0
"VAINODES NOVADS","LATVIJAS NEPILSONIS",0,171,0,1,172
"VAINODES NOVADS","LATVIJAS BEGLIS",0,0,0,0,0
"VAINODES NOVADS","LATVIJAS BEZVALSTNIEKS",0,0,0,0,0
"VAINODES NOVADS","LATVIJAS ALTERNATIVAIS",0,0,0,0,0
"VAINODES NOVADS","PAREJIE",0,31,0,2,33
"VALKAS NOVADS","LATVIJAS PILSONIS",0,7957,0,100,8057
"VALKAS NOVADS","LATVIJAS PAGAIDU AIZSARDZIBA",0,0,0,0,0
"VALKAS NOVADS","LATVIJAS NEPILSONIS",0,655,0,50,705
"VALKAS NOVADS","LATVIJAS BEGLIS",0,0,0,0,0
"VALKAS NOVADS","LATVIJAS BEZVALSTNIEKS",0,0,0,0,0
"VALKAS NOVADS","LATVIJAS ALTERNATIVAIS",0,0,0,0,0
"VALKAS NOVADS","PAREJIE",3,140,1,7,151
"VARAKLANU NOVADS","LATVIJAS PILSONIS",0,3231,1,15,3247
"VARAKLANU NOVADS","LATVIJAS PAGAIDU AIZSARDZIBA",0,0,0,0,0
"VARAKLANU NOVADS","LATVIJAS NEPILSONIS",0,67,0,4,71
"VARAKLANU NOVADS","LATVIJAS BEGLIS",0,0,0,0,0
"VARAKLANU NOVADS","LATVIJAS BEZVALSTNIEKS",0,0,0,0,0
"VARAKLANU NOVADS","LATVIJAS ALTERNATIVAIS",0,0,0,0,0
"VARAKLANU NOVADS","PAREJIE",0,18,0,1,19
"VARKAVAS NOVADS","LATVIJAS PILSONIS",5,1953,0,1,1959
"VARKAVAS NOVADS","LATVIJAS PAGAIDU AIZSARDZIBA",0,0,0,0,0
"VARKAVAS NOVADS","LATVIJAS NEPILSONIS",0,28,0,0,28
"VARKAVAS NOVADS","LATVIJAS BEGLIS",0,0,0,0,0
"VARKAVAS NOVADS","LATVIJAS BEZVALSTNIEKS",0,0,0,0,0
"VARKAVAS NOVADS","LATVIJAS ALTERNATIVAIS",0,0,0,0,0
"VARKAVAS NOVADS","PAREJIE",0,8,0,0,8
"VECPIEBALGAS NOVADS","LATVIJAS PILSONIS",0,3845,1,23,3869
"VECPIEBALGAS NOVADS","LATVIJAS PAGAIDU AIZSARDZIBA",0,0,0,0,0
"VECPIEBALGAS NOVADS","LATVIJAS NEPILSONIS",0,93,0,6,99
"VECPIEBALGAS NOVADS","LATVIJAS BEGLIS",0,0,0,0,0
"VECPIEBALGAS NOVADS","LATVIJAS BEZVALSTNIEKS",0,0,0,0,0
"VECPIEBALGAS NOVADS","LATVIJAS ALTERNATIVAIS",0,0,0,0,0
"VECPIEBALGAS NOVADS","PAREJIE",0,6,0,1,7
"VECUMNIEKU NOVADS","LATVIJAS PILSONIS",0,7891,3,58,7952
"VECUMNIEKU NOVADS","LATVIJAS PAGAIDU AIZSARDZIBA",0,0,0,0,0
"VECUMNIEKU NOVADS","LATVIJAS NEPILSONIS",0,499,1,26,526
"VECUMNIEKU NOVADS","LATVIJAS BEGLIS",0,0,0,0,0
"VECUMNIEKU NOVADS","LATVIJAS BEZVALSTNIEKS",0,1,0,0,1
"VECUMNIEKU NOVADS","LATVIJAS ALTERNATIVAIS",0,1,0,0,1
"VECUMNIEKU NOVADS","PAREJIE",2,85,0,0,87
"VENTSPILS NOVADS","LATVIJAS PILSONIS",0,11144,1,186,11331
"VENTSPILS NOVADS","LATVIJAS PAGAIDU AIZSARDZIBA",0,0,0,0,0
"VENTSPILS NOVADS","LATVIJAS NEPILSONIS",0,423,0,23,446
"VENTSPILS NOVADS","LATVIJAS BEGLIS",0,0,0,0,0
"VENTSPILS NOVADS","LATVIJAS BEZVALSTNIEKS",0,0,0,0,0
"VENTSPILS NOVADS","LATVIJAS ALTERNATIVAIS",0,0,0,0,0
"VENTSPILS NOVADS","PAREJIE",1,117,0,2,120
"VIESITES NOVADS","LATVIJAS PILSONIS",0,3617,0,24,3641
"VIESITES NOVADS","LATVIJAS PAGAIDU AIZSARDZIBA",0,0,0,0,0
"VIESITES NOVADS","LATVIJAS NEPILSONIS",0,226,0,3,229
"VIESITES NOVADS","LATVIJAS BEGLIS",0,0,0,0,0
"VIESITES NOVADS","LATVIJAS BEZVALSTNIEKS",0,0,0,0,0
"VIESITES NOVADS","LATVIJAS ALTERNATIVAIS",0,0,0,0,0
"VIESITES NOVADS","PAREJIE",0,14,0,0,14
"VILAKAS NOVADS","LATVIJAS PILSONIS",0,4900,3,21,4924
"VILAKAS NOVADS","LATVIJAS PAGAIDU AIZSARDZIBA",0,0,0,0,0
"VILAKAS NOVADS","LATVIJAS NEPILSONIS",0,194,0,5,199
"VILAKAS NOVADS","LATVIJAS BEGLIS",0,0,0,0,0
"VILAKAS NOVADS","LATVIJAS BEZVALSTNIEKS",0,0,0,0,0
"VILAKAS NOVADS","LATVIJAS ALTERNATIVAIS",0,0,0,0,0
"VILAKAS NOVADS","PAREJIE",0,35,0,0,35
"VILANU NOVADS","LATVIJAS PILSONIS",1,5774,0,31,5806
"VILANU NOVADS","LATVIJAS PAGAIDU AIZSARDZIBA",0,0,0,0,0
"VILANU NOVADS","LATVIJAS NEPILSONIS",0,187,0,7,194
"VILANU NOVADS","LATVIJAS BEGLIS",0,0,0,0,0
"VILANU NOVADS","LATVIJAS BEZVALSTNIEKS",0,0,0,0,0
"VILANU NOVADS","LATVIJAS ALTERNATIVAIS",0,0,0,0,0
"VILANU NOVADS","PAREJIE",0,45,0,0,45
"ZILUPES NOVADS","LATVIJAS PILSONIS",0,2682,0,22,2704
"ZILUPES NOVADS","LATVIJAS PAGAIDU AIZSARDZIBA",0,0,0,0,0
"ZILUPES NOVADS","LATVIJAS NEPILSONIS",0,262,0,9,271
"ZILUPES NOVADS","LATVIJAS BEGLIS",0,0,0,0,0
"ZILUPES NOVADS","LATVIJAS BEZVALSTNIEKS",0,0,0,0,0
"ZILUPES NOVADS","LATVIJAS ALTERNATIVAIS",0,0,0,0,0
"ZILUPES NOVADS","PAREJIE",0,58,0,0,58
